{
    "T044":  30,
    "T095":  61,
    "T083":  55,
    "T066":  46,
    "T001":  1,
    "T065":  45,
    "T002":  2,
    "T096":  62,
    "T073":  50,
    "T042":  28,
    "T054":  37,
    "T050":  33,
    "T039":  25,
    "T036":  22,
    "T013":  7,
    "T101":  65,
    "T082":  54,
    "T051":  34,
    "T030":  16,
    "T052":  35,
    "T064":  44,
    "T032":  18,
    "T097":  63,
    "T014":  8,
    "T041":  27,
    "T021":  15,
    "T055":  38,
    "T071":  48,
    "T056":  39,
    "T091":  57,
    "T092":  58,
    "T063":  43,
    "T037":  23,
    "T046":  32,
    "T034":  20,
    "T074":  51,
    "T040":  26,
    "T070":  47,
    "T020":  14,
    "T003":  3,
    "T053":  36,
    "T094":  60,
    "T018":  12,
    "T015":  9,
    "T016":  10,
    "T093":  59,
    "T062":  42,
    "T061":  41,
    "T045":  31,
    "T011":  5,
    "T012":  6,
    "T081":  53,
    "T100":  64,
    "T033":  19,
    "T060":  40,
    "T090":  56,
    "T031":  17,
    "T019":  13,
    "T072":  49,
    "T043":  29,
    "T017":  11,
    "T080":  52,
    "T038":  24,
    "T035":  21,
    "T010":  4
}
